1,1,1,0,0,0,0,1,1,1
1,0,0,0,0,0,0,0,0,1
1,0,5,5,6,5,5,5,0,1
0,0,5,5,6,5,5,5,0,0
0,0,5,5,6,5,4,5,0,0
1,0,5,5,6,5,5,5,0,1
1,0,0,0,0,0,7,0,0,1
1,1,1,0,0,0,0,1,1,1
